Initial Map
    0  1  2  3  4  5  6  7  8  9 
 0 [2] ~  ~  ~ [7] ~ [7] ~  ~  ~ 
 1  ~  ~ [7] ~  ~  ~  ~  ~ [7] ~ 

After T = 0
    0  1  2  3  4  5  6  7  8  9 
 0 [2] ~  ~  ~ [7] ~ [7] ~  ~  ~ 
 1  ~  ~ [5] ~  ~  ~  ~  ~ [7] ~ 

After T = 1
    0  1  2  3  4  5  6  7  8  9 
 0 [2] ~  ~  ~ [7] ~ [7] ~  ~  ~ 
 1  ~  ~ [3] ~  ~  ~  ~  ~ [7] ~ 

After T = 2
    0  1  2  3  4  5  6  7  8  9 
 0 [2] ~  ~  ~ [7] ~ [7] ~  ~  ~ 
 1  ~  ~ [1] ~  ~  ~  ~  ~ [7] ~ 

After T = 3
    0  1  2  3  4  5  6  7  8  9 
 0 [2] ~  ~  ~ [7] ~ [7] ~  ~  ~ 
 1  ~  ~  ~  ~  ~  ~  ~  ~ [7] ~ 

After T = 4
    0  1  2  3  4  5  6  7  8  9 
 0 [2] ~  ~  ~ [7] ~ [7] ~  ~  ~ 
 1  ~  ~  ~  ~  ~  ~  ~  ~ [7] ~ 

After T = 5
    0  1  2  3  4  5  6  7  8  9 
 0 [2] ~  ~  ~ [7] ~ [7] ~  ~  ~ 
 1  ~  ~  ~  ~  ~  ~  ~  ~ [7] ~ 

After T = 6
    0  1  2  3  4  5  6  7  8  9 
 0 [2] ~  ~  ~ [7] ~ [7] ~  ~  ~ 
 1  ~  ~  ~  ~  ~  ~  ~  ~ [7] ~ 

After T = 7
    0  1  2  3  4  5  6  7  8  9 
 0 [2] ~  ~  ~ [7] ~ [7] ~  ~  ~ 
 1  ~  ~  ~  ~  ~  ~  ~  ~ [7] ~ 

After T = 8
    0  1  2  3  4  5  6  7  8  9 
 0 [2] ~  ~  ~ [7] ~ [7] ~  ~  ~ 
 1  ~  ~  ~  ~  ~  ~  ~  ~ [7] ~ 

After T = 9
    0  1  2  3  4  5  6  7  8  9 
 0 [2] ~  ~  ~ [7] ~ [7] ~  ~  ~ 
 1  ~  ~  ~  ~  ~  ~  ~  ~ [7] ~ 

After T = 10
    0  1  2  3  4  5  6  7  8  9 
 0 [2] ~  ~  ~ [7] ~ [7] ~  ~  ~ 
 1  ~  ~  ~  ~  ~  ~  ~  ~ [7] ~ 

After T = 11
    0  1  2  3  4  5  6  7  8  9 
 0 [2] ~  ~  ~ [7] ~ [7] ~  ~  ~ 
 1  ~  ~  ~  ~  ~  ~  ~  ~ [7] ~ 

After T = 12
    0  1  2  3  4  5  6  7  8  9 
 0 [2] ~  ~  ~ [7] ~ [7] ~  ~  ~ 
 1  ~  ~  ~  ~  ~  ~  ~  ~ [7] ~ 

After T = 13
    0  1  2  3  4  5  6  7  8  9 
 0 [2] ~  ~  ~ [7] ~ [7] ~  ~  ~ 
 1  ~  ~  ~  ~  ~  ~  ~  ~ [7] ~ 

After T = 14
    0  1  2  3  4  5  6  7  8  9 
 0 [2] ~  ~  ~ [7] ~ [7] ~  ~  ~ 
 1  ~  ~  ~  ~  ~  ~  ~  ~ [7] ~ 

After T = 15
    0  1  2  3  4  5  6  7  8  9 
 0 [2] ~  ~  ~ [7] ~ [7] ~  ~  ~ 
 1  ~  ~  ~  ~  ~  ~  ~  ~ [7] ~ 

After T = 16
    0  1  2  3  4  5  6  7  8  9 
 0 [2] ~  ~  ~ [7] ~ [7] ~  ~  ~ 
 1  ~  ~  ~  ~  ~  ~  ~  ~ [7] ~ 

After T = 17
    0  1  2  3  4  5  6  7  8  9 
 0 [2] ~  ~  ~ [7] ~ [7] ~  ~  ~ 
 1  ~  ~  ~  ~  ~  ~  ~  ~ [7] ~ 

After T = 18
    0  1  2  3  4  5  6  7  8  9 
 0 [2] ~  ~  ~ [7] ~ [7] ~  ~  ~ 
 1  ~  ~  ~  ~  ~  ~  ~  ~ [7] ~ 

After T = 19
    0  1  2  3  4  5  6  7  8  9 
 0 [2] ~  ~  ~ [7] ~ [7] ~  ~  ~ 
 1  ~  ~  ~  ~  ~  ~  ~  ~ [7] ~ 

After T = 20
    0  1  2  3  4  5  6  7  8  9 
 0 [2] ~  ~  ~ [7] ~ [7] ~  ~  ~ 
 1  ~  ~  ~  ~  ~  ~  ~  ~ [7] ~ 

After T = 21
    0  1  2  3  4  5  6  7  8  9 
 0 [2] ~  ~  ~ [7] ~ [7] ~  ~  ~ 
 1  ~  ~  ~  ~  ~  ~  ~  ~ [7] ~ 

After T = 22
    0  1  2  3  4  5  6  7  8  9 
 0 [2] ~  ~  ~ [7] ~ [7] ~  ~  ~ 
 1  ~  ~  ~  ~  ~  ~  ~  ~ [7] ~ 

After T = 23
    0  1  2  3  4  5  6  7  8  9 
 0 [2] ~  ~  ~ [7] ~ [7] ~  ~  ~ 
 1  ~  ~  ~  ~  ~  ~  ~  ~ [7] ~ 

After T = 24
    0  1  2  3  4  5  6  7  8  9 
 0 [2] ~  ~  ~ [7] ~ [7] ~  ~  ~ 
 1  ~  ~  ~  ~  ~  ~  ~  ~ [7] ~ 

After T = 25
    0  1  2  3  4  5  6  7  8  9 
 0 [2] ~  ~  ~ [7] ~ [7] ~  ~  ~ 
 1  ~  ~  ~  ~  ~  ~  ~  ~ [7] ~ 

After T = 26
    0  1  2  3  4  5  6  7  8  9 
 0 [2] ~  ~  ~ [7] ~ [7] ~  ~  ~ 
 1  ~  ~  ~  ~  ~  ~  ~  ~ [7] ~ 

After T = 27
    0  1  2  3  4  5  6  7  8  9 
 0 [2] ~  ~  ~ [7] ~ [7] ~  ~  ~ 
 1  ~  ~  ~  ~  ~  ~  ~  ~ [7] ~ 

After T = 28
    0  1  2  3  4  5  6  7  8  9 
 0 [2] ~  ~  ~ [7] ~ [7] ~  ~  ~ 
 1  ~  ~  ~  ~  ~  ~  ~  ~ [7] ~ 

After T = 29
    0  1  2  3  4  5  6  7  8  9 
 0 [2] ~  ~  ~ [7] ~ [7] ~  ~  ~ 
 1  ~  ~  ~  ~  ~  ~  ~  ~ [7] ~ 

After T = 30
    0  1  2  3  4  5  6  7  8  9 
 0 [2] ~  ~  ~ [7] ~ [7] ~  ~  ~ 
 1  ~  ~  ~  ~  ~  ~  ~  ~ [7] ~ 

After T = 31
    0  1  2  3  4  5  6  7  8  9 
 0 [2] ~  ~  ~ [7] ~ [7] ~  ~  ~ 
 1  ~  ~  ~  ~  ~  ~  ~  ~ [7] ~ 

After T = 32
    0  1  2  3  4  5  6  7  8  9 
 0 [2] ~  ~  ~ [7] ~ [7] ~  ~  ~ 
 1  ~  ~  ~  ~  ~  ~  ~  ~ [7] ~ 

After T = 33
    0  1  2  3  4  5  6  7  8  9 
 0 [2] ~  ~  ~ [7] ~ [7] ~  ~  ~ 
 1  ~  ~  ~  ~  ~  ~  ~  ~ [7] ~ 

After T = 34
    0  1  2  3  4  5  6  7  8  9 
 0 [2] ~  ~  ~ [7] ~ [7] ~  ~  ~ 
 1  ~  ~  ~  ~  ~  ~  ~  ~ [7] ~ 

After T = 35
    0  1  2  3  4  5  6  7  8  9 
 0 [2] ~  ~  ~ [7] ~ [7] ~  ~  ~ 
 1  ~  ~  ~  ~  ~  ~  ~  ~ [7] ~ 

After T = 36
    0  1  2  3  4  5  6  7  8  9 
 0 [2] ~  ~  ~ [7] ~ [7] ~  ~  ~ 
 1  ~  ~  ~  ~  ~  ~  ~  ~ [7] ~ 

After T = 37
    0  1  2  3  4  5  6  7  8  9 
 0 [2] ~  ~  ~ [7] ~ [7] ~  ~  ~ 
 1  ~  ~  ~  ~  ~  ~  ~  ~ [7] ~ 

After T = 38
    0  1  2  3  4  5  6  7  8  9 
 0 [2] ~  ~  ~ [7] ~ [7] ~  ~  ~ 
 1  ~  ~  ~  ~  ~  ~  ~  ~ [7] ~ 

After T = 39
    0  1  2  3  4  5  6  7  8  9 
 0 [2] ~  ~  ~ [7] ~ [7] ~  ~  ~ 
 1  ~  ~  ~  ~  ~  ~  ~  ~ [7] ~ 

After T = 40
    0  1  2  3  4  5  6  7  8  9 
 0 [2] ~  ~  ~ [7] ~ [7] ~  ~  ~ 
 1  ~  ~  ~  ~  ~  ~  ~  ~ [7] ~ 

After T = 41
    0  1  2  3  4  5  6  7  8  9 
 0 [2] ~  ~  ~ [7] ~ [7] ~  ~  ~ 
 1  ~  ~  ~  ~  ~  ~  ~  ~ [7] ~ 

After T = 42
    0  1  2  3  4  5  6  7  8  9 
 0 [2] ~  ~  ~ [7] ~ [7] ~  ~  ~ 
 1  ~  ~  ~  ~  ~  ~  ~  ~ [7] ~ 

After T = 43
    0  1  2  3  4  5  6  7  8  9 
 0 [2] ~  ~  ~ [7] ~ [7] ~  ~  ~ 
 1  ~  ~  ~  ~  ~  ~  ~  ~ [7] ~ 

After T = 44
    0  1  2  3  4  5  6  7  8  9 
 0 [2] ~  ~  ~ [7] ~ [7] ~  ~  ~ 
 1  ~  ~  ~  ~  ~  ~  ~  ~ [7] ~ 

After T = 45
    0  1  2  3  4  5  6  7  8  9 
 0 [2] ~  ~  ~ [7] ~ [7] ~  ~  ~ 
 1  ~  ~  ~  ~  ~  ~  ~  ~ [7] ~ 

After T = 46
    0  1  2  3  4  5  6  7  8  9 
 0 [2] ~  ~  ~ [7] ~ [7] ~  ~  ~ 
 1  ~  ~  ~  ~  ~  ~  ~  ~ [7] ~ 

After T = 47
    0  1  2  3  4  5  6  7  8  9 
 0 [2] ~  ~  ~ [7] ~ [7] ~  ~  ~ 
 1  ~  ~  ~  ~  ~  ~  ~  ~ [7] ~ 

After T = 48
    0  1  2  3  4  5  6  7  8  9 
 0 [2] ~  ~  ~ [7] ~ [7] ~  ~  ~ 
 1  ~  ~  ~  ~  ~  ~  ~  ~ [7] ~ 

After T = 49
    0  1  2  3  4  5  6  7  8  9 
 0 [2] ~  ~  ~ [7] ~ [7] ~  ~  ~ 
 1  ~  ~  ~  ~  ~  ~  ~  ~ [7] ~ 

