Initial Map
    0  1  2  3  4  5  6  7  8  9 
 0  ~  ~  ~  ~ [7][7] ~  ~  ~  ~ 
 1  ~  ~  ~ [7] ~  ~ [7] ~  ~  ~ 
 2  ~  ~  ~  ~  ~  ~  ~  ~  ~  ~ 
 3  ~  ~  ~  ~  ~  ~  ~  ~  ~  ~ 
 4  ~  ~  ~  ~  ~  ~  ~  ~  ~  ~ 
 5  ~  ~  ~  ~  ~ [2] ~  ~  ~  ~ 
 6  ~  ~  ~  ~  ~  ~  ~  ~  ~  ~ 
 7  ~  ~  ~  ~  ~  ~  ~  ~  ~  ~ 
 8  ~  ~  ~  ~  ~  ~  ~  ~  ~  ~ 
 9  ~  ~  ~  ~  ~  ~  ~  ~  ~  ~ 

After T = 0
    0  1  2  3  4  5  6  7  8  9 
 0  ~  ~  ~  ~ [7][7] ~  ~  ~  ~ 
 1  ~  ~  ~ [5] ~  ~ [7] ~  ~  ~ 
 2  ~  ~  ~  ~  ~ [2] ~  ~  ~  ~ 
 3  ~  ~  ~  ~  ~  ~  ~  ~  ~  ~ 
 4  ~  ~  ~  ~  ~  ~  ~  ~  ~  ~ 
 5  ~  ~  ~  ~  ~  ~  ~  ~  ~  ~ 
 6  ~  ~  ~  ~  ~  ~  ~  ~  ~  ~ 
 7  ~  ~  ~  ~  ~  ~  ~  ~  ~  ~ 
 8  ~  ~  ~  ~  ~  ~  ~  ~  ~  ~ 
 9  ~  ~  ~  ~  ~  ~  ~  ~  ~  ~ 

After T = 1
    0  1  2  3  4  5  6  7  8  9 
 0  ~  ~  ~  ~ [7][7] ~  ~  ~  ~ 
 1  ~  ~  ~ [3] ~ [2][7] ~  ~  ~ 
 2  ~  ~  ~  ~  ~  ~  ~  ~  ~  ~ 
 3  ~  ~  ~  ~  ~  ~  ~  ~  ~  ~ 
 4  ~  ~  ~  ~  ~  ~  ~  ~  ~  ~ 
 5  ~  ~  ~  ~  ~  ~  ~  ~  ~  ~ 
 6  ~  ~  ~  ~  ~  ~  ~  ~  ~  ~ 
 7  ~  ~  ~  ~  ~  ~  ~  ~  ~  ~ 
 8  ~  ~  ~  ~  ~  ~  ~  ~  ~  ~ 
 9  ~  ~  ~  ~  ~  ~  ~  ~  ~  ~ 

After T = 2
    0  1  2  3  4  5  6  7  8  9 
 0  ~  ~  ~  ~ [7][7] ~  ~  ~  ~ 
 1  ~  ~  ~ [1] ~ [2][7] ~  ~  ~ 
 2  ~  ~  ~  ~  ~  ~  ~  ~  ~  ~ 
 3  ~  ~  ~  ~  ~  ~  ~  ~  ~  ~ 
 4  ~  ~  ~  ~  ~  ~  ~  ~  ~  ~ 
 5  ~  ~  ~  ~  ~  ~  ~  ~  ~  ~ 
 6  ~  ~  ~  ~  ~  ~  ~  ~  ~  ~ 
 7  ~  ~  ~  ~  ~  ~  ~  ~  ~  ~ 
 8  ~  ~  ~  ~  ~  ~  ~  ~  ~  ~ 
 9  ~  ~  ~  ~  ~  ~  ~  ~  ~  ~ 

After T = 3
    0  1  2  3  4  5  6  7  8  9 
 0  ~  ~  ~  ~ [7][7] ~  ~  ~  ~ 
 1  ~  ~  ~  ~  ~ [2][7] ~  ~  ~ 
 2  ~  ~  ~  ~  ~  ~  ~  ~  ~  ~ 
 3  ~  ~  ~  ~  ~  ~  ~  ~  ~  ~ 
 4  ~  ~  ~  ~  ~  ~  ~  ~  ~  ~ 
 5  ~  ~  ~  ~  ~  ~  ~  ~  ~  ~ 
 6  ~  ~  ~  ~  ~  ~  ~  ~  ~  ~ 
 7  ~  ~  ~  ~  ~  ~  ~  ~  ~  ~ 
 8  ~  ~  ~  ~  ~  ~  ~  ~  ~  ~ 
 9  ~  ~  ~  ~  ~  ~  ~  ~  ~  ~ 

After T = 4
    0  1  2  3  4  5  6  7  8  9 
 0  ~  ~  ~  ~ [5][7] ~  ~  ~  ~ 
 1  ~  ~  ~  ~  ~ [2][7] ~  ~  ~ 
 2  ~  ~  ~  ~  ~  ~  ~  ~  ~  ~ 
 3  ~  ~  ~  ~  ~  ~  ~  ~  ~  ~ 
 4  ~  ~  ~  ~  ~  ~  ~  ~  ~  ~ 
 5  ~  ~  ~  ~  ~  ~  ~  ~  ~  ~ 
 6  ~  ~  ~  ~  ~  ~  ~  ~  ~  ~ 
 7  ~  ~  ~  ~  ~  ~  ~  ~  ~  ~ 
 8  ~  ~  ~  ~  ~  ~  ~  ~  ~  ~ 
 9  ~  ~  ~  ~  ~  ~  ~  ~  ~  ~ 

After T = 5
    0  1  2  3  4  5  6  7  8  9 
 0  ~  ~  ~  ~ [3][7] ~  ~  ~  ~ 
 1  ~  ~  ~  ~  ~ [2][7] ~  ~  ~ 
 2  ~  ~  ~  ~  ~  ~  ~  ~  ~  ~ 
 3  ~  ~  ~  ~  ~  ~  ~  ~  ~  ~ 
 4  ~  ~  ~  ~  ~  ~  ~  ~  ~  ~ 
 5  ~  ~  ~  ~  ~  ~  ~  ~  ~  ~ 
 6  ~  ~  ~  ~  ~  ~  ~  ~  ~  ~ 
 7  ~  ~  ~  ~  ~  ~  ~  ~  ~  ~ 
 8  ~  ~  ~  ~  ~  ~  ~  ~  ~  ~ 
 9  ~  ~  ~  ~  ~  ~  ~  ~  ~  ~ 

After T = 6
    0  1  2  3  4  5  6  7  8  9 
 0  ~  ~  ~  ~ [1][7] ~  ~  ~  ~ 
 1  ~  ~  ~  ~  ~ [2][7] ~  ~  ~ 
 2  ~  ~  ~  ~  ~  ~  ~  ~  ~  ~ 
 3  ~  ~  ~  ~  ~  ~  ~  ~  ~  ~ 
 4  ~  ~  ~  ~  ~  ~  ~  ~  ~  ~ 
 5  ~  ~  ~  ~  ~  ~  ~  ~  ~  ~ 
 6  ~  ~  ~  ~  ~  ~  ~  ~  ~  ~ 
 7  ~  ~  ~  ~  ~  ~  ~  ~  ~  ~ 
 8  ~  ~  ~  ~  ~  ~  ~  ~  ~  ~ 
 9  ~  ~  ~  ~  ~  ~  ~  ~  ~  ~ 

After T = 7
    0  1  2  3  4  5  6  7  8  9 
 0  ~  ~  ~  ~  ~ [7] ~  ~  ~  ~ 
 1  ~  ~  ~  ~  ~ [2][7] ~  ~  ~ 
 2  ~  ~  ~  ~  ~  ~  ~  ~  ~  ~ 
 3  ~  ~  ~  ~  ~  ~  ~  ~  ~  ~ 
 4  ~  ~  ~  ~  ~  ~  ~  ~  ~  ~ 
 5  ~  ~  ~  ~  ~  ~  ~  ~  ~  ~ 
 6  ~  ~  ~  ~  ~  ~  ~  ~  ~  ~ 
 7  ~  ~  ~  ~  ~  ~  ~  ~  ~  ~ 
 8  ~  ~  ~  ~  ~  ~  ~  ~  ~  ~ 
 9  ~  ~  ~  ~  ~  ~  ~  ~  ~  ~ 

After T = 8
    0  1  2  3  4  5  6  7  8  9 
 0  ~  ~  ~  ~  ~ [5] ~  ~  ~  ~ 
 1  ~  ~  ~  ~  ~ [2][7] ~  ~  ~ 
 2  ~  ~  ~  ~  ~  ~  ~  ~  ~  ~ 
 3  ~  ~  ~  ~  ~  ~  ~  ~  ~  ~ 
 4  ~  ~  ~  ~  ~  ~  ~  ~  ~  ~ 
 5  ~  ~  ~  ~  ~  ~  ~  ~  ~  ~ 
 6  ~  ~  ~  ~  ~  ~  ~  ~  ~  ~ 
 7  ~  ~  ~  ~  ~  ~  ~  ~  ~  ~ 
 8  ~  ~  ~  ~  ~  ~  ~  ~  ~  ~ 
 9  ~  ~  ~  ~  ~  ~  ~  ~  ~  ~ 

After T = 9
    0  1  2  3  4  5  6  7  8  9 
 0  ~  ~  ~  ~  ~ [3] ~  ~  ~  ~ 
 1  ~  ~  ~  ~  ~ [2][7] ~  ~  ~ 
 2  ~  ~  ~  ~  ~  ~  ~  ~  ~  ~ 
 3  ~  ~  ~  ~  ~  ~  ~  ~  ~  ~ 
 4  ~  ~  ~  ~  ~  ~  ~  ~  ~  ~ 
 5  ~  ~  ~  ~  ~  ~  ~  ~  ~  ~ 
 6  ~  ~  ~  ~  ~  ~  ~  ~  ~  ~ 
 7  ~  ~  ~  ~  ~  ~  ~  ~  ~  ~ 
 8  ~  ~  ~  ~  ~  ~  ~  ~  ~  ~ 
 9  ~  ~  ~  ~  ~  ~  ~  ~  ~  ~ 

After T = 10
    0  1  2  3  4  5  6  7  8  9 
 0  ~  ~  ~  ~  ~ [1] ~  ~  ~  ~ 
 1  ~  ~  ~  ~  ~ [2][7] ~  ~  ~ 
 2  ~  ~  ~  ~  ~  ~  ~  ~  ~  ~ 
 3  ~  ~  ~  ~  ~  ~  ~  ~  ~  ~ 
 4  ~  ~  ~  ~  ~  ~  ~  ~  ~  ~ 
 5  ~  ~  ~  ~  ~  ~  ~  ~  ~  ~ 
 6  ~  ~  ~  ~  ~  ~  ~  ~  ~  ~ 
 7  ~  ~  ~  ~  ~  ~  ~  ~  ~  ~ 
 8  ~  ~  ~  ~  ~  ~  ~  ~  ~  ~ 
 9  ~  ~  ~  ~  ~  ~  ~  ~  ~  ~ 

After T = 11
    0  1  2  3  4  5  6  7  8  9 
 0  ~  ~  ~  ~  ~ [2] ~  ~  ~  ~ 
 1  ~  ~  ~  ~  ~  ~ [7] ~  ~  ~ 
 2  ~  ~  ~  ~  ~  ~  ~  ~  ~  ~ 
 3  ~  ~  ~  ~  ~  ~  ~  ~  ~  ~ 
 4  ~  ~  ~  ~  ~  ~  ~  ~  ~  ~ 
 5  ~  ~  ~  ~  ~  ~  ~  ~  ~  ~ 
 6  ~  ~  ~  ~  ~  ~  ~  ~  ~  ~ 
 7  ~  ~  ~  ~  ~  ~  ~  ~  ~  ~ 
 8  ~  ~  ~  ~  ~  ~  ~  ~  ~  ~ 
 9  ~  ~  ~  ~  ~  ~  ~  ~  ~  ~ 

